######
#@ox #
#  # #
#    #
######
