########
# @#   #
#  o   #
#x #  ##
########